%%%%%%%%%%%%%%%%%%%%%%%%%%%%%%%%%%%%
%     %  %        %  %  % .      P%%
%%%% o%  %  %%%%  %  %  %  %   %%%%%
%  %           %  %        %      %%
%  %  %%%%  %  %  %  %%%%%%%  %   %%
%  %     %  %  %  %  %        %%  %%
%  %%%%  %%%%  %  %  %%%%%%%   %  %%
%     %   . %  %     %        %   %%
%  %  %  %%%%  %%%%%%%%%%%%%  %%%%%%
%  % o      %     %  %  %  %      %%
%  %%%%  %%%%%%%  %  %  %  %%%% . %%
%     %        %              %   %%
%  %  %%%%%%%%%%  %  %  %%%%  %%  %%
%  %     %     %  %o %  %  %  %  %%%
%  %%%%%%%%%%  %%%%%%%  %  %  %   %%
%.                      %         %%
%%%%%%%%%%%%%%%%%%%%%%%%%%%%%%%%%%%%