%%%%%%%
%P % .%
%o %  %
%   . %
%%%%  %
%.   o%
%%%%% %